PE: Language and Literatures: English
DQ: History: General and Eastern Hemisphere: Switzerland
F2201: Latin America local history: South America. General
AE: General Works: Encyclopedias
F975: United States local history: Central American, West Indian, and other countries protected by and having close political affiliations with the United States
HE: Social sciences: Transportation and communications
HN: Social sciences: Social history and conditions, Social problems
F396: United States local history: Old Southwest. Lower Mississippi Valley
E740: History: America: Twentieth century
SD: Agriculture: Forestry
PA: Language and Literatures: Classical Languages and Literature
JK: Political science: Political inst. and pub. Admin.: United States
QD: Science: Chemistry
BM: Philosophy, Psychology, Religion: Judaism
BC: Philosophy, Psychology, Religion: Logic
HC: Social sciences: Economic history and conditions, Special topics
F2155: History of the Americas: Caribbean area. Caribbean sea
F2301: Latin America local history: Venezuela
TE: Technology: Highway engineering, Roads and pavements
DD: History: General and Eastern Hemisphere: Germany
BS: Philosophy, Psychology, Religion: Christianity: The Bible, Old and New Testament
TN: Technology: Mining engineering, Metallurgy
CS: History: Genealogy
AG: General Works: Dictionaries and other general reference books
E186: History: America: Colonial History (1607-1775)
F786: United States local history: New Southwest. Colorado River, Canyon, and Valley
TX: Technology: Home economics
QE: Science: Geology
E895: History: America: Twenty-first century
TR: Technology: Photography
LT: Education: Textbooks
CB: History: History of civilization
TK: Technology: Electrical, Electronics and Nuclear engineering
CT: History: Biography
TA: Technology: Engineering and Civil engineering
E660: History: America: Late nineteenth century (1865-1900)
NX: Fine Arts: Arts in general
GN: Geography, Anthropology, Recreation: Anthropology
RL: Medicine: Dermatology
KD: Law in general, Comparative and uniform law, Jurisprudence: United Kingdom and Ireland
BP: Philosophy, Psychology, Religion: Islam, Bahaism, Theosophy, Other and new beliefs
TT: Technology: Handicrafts, Arts and crafts
SK: Agriculture: Hunting sports
CN: History: Inscriptions, Epigraphy
HA: Social sciences: Statistics
CC: History: Archaeology
UA: Military science: Armies: Organization, distribution, military situation
BD: Philosophy, Psychology, Religion: Speculative Philosophy, General Philosophical works
PS: Language and Literatures: American and Canadian literature
LC: Education: Special aspects of education
PC: Language and Literatures: Romance languages: Italian, French, Spanish, Portuguese
F1541: Latin America local history: Costa Rica
HQ: Social sciences: The family, Marriage, Sex and Gender
F3401: Latin America local history: Peru
PZ: Language and Literatures: Juvenile belles lettres
ML: Music: Literature of music
PH: Language and Literatures: Finno-Ugrian and Basque languages and literatures
N: Fine Arts
UH: Military science: Other services
NB: Fine Arts: Sculpture
KL: Law in general, Comparative and uniform law, Jurisprudence: Asia and Eurasia, Africa, Pacific Area, and Antarctica
QH: Science: Natural history
PD: Language and Literatures: Germanic and Scandinavian languages
MT: Music: Musical instruction and study, Composition
DP: History: General and Eastern Hemisphere: Spain, Portugal
TH: Technology: Building construction
KE: Law in general, Comparative and uniform law, Jurisprudence: Canada
RG: Medicine: Gynecology and obstetrics
F001: United States local history: New England
JF: Political science: Political institutions and public administration
DJK: History: General and Eastern Hemisphere: Eastern Europe
HS: Social sciences: Societies: secret, benevolent, etc.
F206: United States local history: The South. South Atlantic States
RT: Medicine: Nursing
DJ: History: General and Eastern Hemisphere: Netherlands
F2661: Latin America local history: Paraguay
H: Social sciences
SB: Agriculture: Plant culture
F3301: Latin America local history: Bolivia
AC: General Works: Collections, Series, Collected works, Pamphlets
DR: History: General and Eastern Hemisphere: Balkan Peninsula, Turkey
JX: Political science: International law
QR: Science: Microbiology
F1401: Latin America local history: General
U: Military science
E456: History: America: Civil War period (1861-1865)
PQ: Language and Literatures: Romance literatures: French, Italian, Spanish, Portuguese
E838: History: America: Later twentieth century (1961-)
PM: Language and Literatures: Indigenous American and Artificial Languages
VM: Naval science: Naval architecture, Shipbuilding, Marine engineering
BQ: Philosophy, Psychology, Religion: Buddhism
E011: History: America: America
HD: Social sciences: Economic history and conditions, Production
PB: Language and Literatures: General works
RV: Medicine: Botanic, Thomsonian, and eclectic medicine
BR: Philosophy, Psychology, Religion: Christianity
TS: Technology: Manufactures
QL: Science: Zoology
LA: Education: History of education
K: Law in general, Comparative and uniform law, Jurisprudence
QB: Science: Astronomy
RD: Medicine: Surgery
KDZ: Law in general, Comparative and uniform law, Jurisprudence: America, North America
S: Agriculture
RA: Medicine: Public aspects of medicine
F476: United States local history: Old Northwest. Northwest Territory
VA: Naval science: Navies: Organization, distribution, naval situation
J: Political science
F2251: Latin America local history: Colombia
F350.5: United States local history: Mississippi River and Valley. Middle West
UG: Military science: Military engineering
DA: History: General and Eastern Hemisphere: Great Britain, Ireland, Central Europe
DK: History: General and Eastern Hemisphere: Russia, Former Soviet Republics, Poland
HX: Social sciences: Socialism, Communism, Anarchism
NA: Fine Arts: Architecture
GV: Geography, Anthropology, Recreation: Recreation, Leisure
F721: United States local history: Rocky Mountains. Yellowstone National Park
JN: Political science: Political inst. and pub. Admin.: Europe
TG: Technology: Bridge engineering
T: Technology
F3051: Latin America local history: Chile
PK: Language and Literatures: Indo-Iranian literatures
HJ: Social sciences: Public finance
QH301: Science: Biology
DS: History: General and Eastern Hemisphere: Asia
QM: Science: Human anatomy
RX: Medicine: Homeopathy
BX: Philosophy, Psychology, Religion: Christianity: Churches, Church movements
F850.5: United States local history: Pacific States
CR: History: Heraldry
DT: History: General and Eastern Hemisphere: Africa
LB: Education: Theory and practice of education
BF: Philosophy, Psychology, Religion: Psychology, Philosophy, Psychoanalysis
JS: Political science: Local government, Municipal government
VK: Naval science: Navigation, Merchant marine
UE: Military science: Cavalry, Armor
QP: Science: Physiology
HB: Social sciences: Economic theory, Demography
G: Geography, Anthropology, Recreation
DC: History: General and Eastern Hemisphere: France, Andorra, Monaco
RM: Medicine: Therapeutics, Pharmacology
PL: Language and Literatures: Languages and literatures of Eastern Asia, Africa, Oceania
E151: History: America: United States
F1001: North America local history: Canada
QK: Science: Botany
SF: Agriculture: Animal culture
JV: Political science: Colonies and colonization, International migration
JC: Political science: Political theory
D501: History: General and Eastern Hemisphere: World War I (1914-1918)
KZ: Law in general, Comparative and uniform law, Jurisprudence: Law of nations
HT: Social sciences: Communities, Classes, Races
GT: Geography, Anthropology, Recreation: Manners and customs
RJ: Medicine: Pediatrics
TJ: Technology: Mechanical engineering and machinery
LF: Education: Individual institutions: Europe
PN: Language and Literatures: Literature: General, Criticism, Collections
DU: History: General and Eastern Hemisphere: History of Oceania (South Seas)
F1201: North America local history: Mexico
F590.3: United States local history: The West. Trans-Mississippi Region. Great Plains
B: Philosophy, Psychology, Religion
HF: Social sciences: Commerce
DG: History: General and Eastern Hemisphere: Italy, Vatican City, Malta
BT: Philosophy, Psychology, Religion: Christianity: Doctrinal theology, God, Christology
JQ: Political science: Political inst. and pub. Admin.: Asia, Africa and Oceania
F516: United States local history: Ohio River and Valley.
NE: Fine Arts: Print media
QC: Science: Physics
QA: Science: Mathematics
PF: Language and Literatures: West Germanic
PG: Language and Literatures: Slavic (including Russian), Languages and Literature
RC: Medicine: Internal medicine
RF: Medicine: Otorhinolaryngology
ND: Fine Arts: Painting
KJ: Law in general, Comparative and uniform law, Jurisprudence: Europe
Q: Science
E201: History: America: Revolution (1775-1783)
F2501: Latin America local history: Brazil
P: Language and Literatures
TL: Technology: Motor vehicles, Aeronautics, Astronautics
DL: History: General and Eastern Hemisphere: Northern Europe, Scandinavia
TC: Technology: Ocean engineering
BH: Philosophy, Psychology, Religion: Aesthetics
BV: Philosophy, Psychology, Religion: Christianity: Practical theology, Worship
BJ: Philosophy, Psychology, Religion: Ethics, Social usages, Etiquette, Religion
F106: United States local history: Atlantic coast. Middle Atlantic States
CJ: History: Numismatics
KBR: Law in general, Comparative and uniform law, Jurisprudence: History of canon law
KH: Law in general, Comparative and uniform law, Jurisprudence: South America
D: History: General and Eastern Hemisphere
AP: General Works: Periodicals
F1951: West Indies local history: Puerto Rico
KNX: Law in general, Comparative and uniform law, Jurisprudence: Japan
GF: Geography, Anthropology, Recreation: Human ecology, Anthropogeography
PR: Language and Literatures: English literature
RZ: Medicine: Other systems of medicine
RB: Medicine: Pathology
TF: Technology: Railroad engineering and operation
HV: Social sciences: Social pathology, Social and Public Welfare
DF: History: General and Eastern Hemisphere: Greece
RS: Medicine: Pharmacy and materia medica
PT: Language and Literatures: Germanic, Scandinavian, and Icelandic literatures
JL: Political science: Political inst. and pub. Admin.: America
F2001: History of the Americas: Lesser Antilles
F1561: Latin America local history: Panama
GC: Geography, Anthropology, Recreation: Oceanography
DE: History: General and Eastern Hemisphere: The Mediterranean Region, The Greco-Roman World
F1501: Latin America local history: Honduras
GB: Geography, Anthropology, Recreation: Physical geography
ZA: Bibliography, Library science: Information resources
TP: Technology: Chemical technology
GR: Geography, Anthropology, Recreation: Folklore
F2801: Latin America local history: Argentina
E300: History: America: Revolution to the Civil War (1783-1861)
UF: Military science: Artillery
AZ: General Works: History of scholarship and learning, The humanities
DX: History: General and Eastern Hemisphere: History of Gypsies
AS: General Works: Academies and International Associations, Congresses
V: Naval science
HG: Social sciences: Finance
SH: Agriculture: Aquaculture, Fisheries, Angling
JA: Political science: Political science
PJ: Language and Literatures: Oriental languages and literatures
LE: Education: Individual institutions: America (except US)
F1751: History of the Americas: Caribbean area. Cuba
KF: Law in general, Comparative and uniform law, Jurisprudence: United States
R: Medicine
NC: Fine Arts: Drawing, Design, Illustration
LD: Education: Individual institutions: United States
DH: History: General and Eastern Hemisphere: Netherlands, Belgium, Luxemburg
BL: Philosophy, Psychology, Religion: Religion: General, Miscellaneous and Atheism
HM: Social sciences: Sociology
DB: History: General and Eastern Hemisphere: Austria, Hungary, Czech Republic, Slovakia
NK: Fine Arts: Decorative and Applied Arts, Decoration and Ornament
RK: Medicine: Dentistry
L: Education
M: Music
Z: Bibliography, Library science
